1111111111
1P00100001
1000E00001
1000000001
111110P001
10C0000001
1111111111