1111111111
1001000001
1001E11111

1001000001
100C00P101
1000000101
1111111111