1111101111
1000000001
1000E00001
1000000001
100000P001
10C0000001
1111111111