1111111111
1000100001
1001E10001
1000100001
100000P001
10C0000001
1111111111