1111111111
1001000001
1000000001
1000000001
1000E11001
10C0000001
1111100001
1000000001
1000000001
1111111111