1111111111
1000000001
1000E00C01
1000000001
111000P001
10C1000001
1111111111