1111111111
1001000001
1001E11111
1001000001
100500P101
100C000101
1111111111