111111111111111111
1P000000000A000AE1
1C0001111100000001
111101000110000001
1C0000000000000101
1000A10000111111C1
111111111111111111