111111111111
110000000001
1A0000C000A1
100000000001
101000000001
101000000001
101111111101
1000C0000001
110001000001
100001000001
100001000001
100001000001
100001E00001
100001110011
10000P000001
100000000001
111111111111